0 0 0 0 0 0 0 0 0 0 0 0 0 0 0 0 0 0 0 0 0 0 0 0 0 0 0 0 0 0 0 0 0 0 0 0 0 0 0 0 0 0 0 0 0 0 0 0 0 0 0 0 0 0 0 0
180 10 10 0 180 10 10 0 180 10 10 0 180 10 10 0 180 10 10 0 180 10 10 0 180 10 10 0 180 10 10 0 180 10 10 0 180 10 10 0 180 10 10 0 180 10 10 0 180 10 10 0 180 10 10 0
180 10 10 0 180 10 10 0 180 10 10 0 180 10 10 0 180 10 10 0 180 10 10 0 180 10 10 0 180 10 10 0 180 10 10 0 180 10 10 0 180 10 10 0 180 10 10 0 180 10 10 0 
180 50 10 0 180 50 10 0 180 50 10 0 180 50 10 0 180 50 10 0 180 50 10 0 180 50 10 0 180 50 10 0 180 50 10 0 180 50 10 0 180 50 10 0 180 50 10 0 180 50 10 0 
180 50 10 0 180 50 10 0 180 50 10 0 180 50 10 0 180 50 10 0 180 50 10 0 180 50 10 0 180 50 10 0 180 50 10 0 180 50 10 0 180 50 10 0 180 50 10 0 180 50 10 0 
180 70 20 0 180 70 20 0 180 70 20 0 180 70 20 0 180 70 20 0 180 70 20 0 180 70 20 0 180 70 20 0 180 70 20 0 180 70 20 0 180 70 20 0 180 70 20 0 180 70 20 0 
180 70 20 0 180 70 20 0 180 70 20 0 180 70 20 0 180 70 20 0 180 70 20 0 180 70 20 0 180 70 20 0 180 70 20 0 180 70 20 0 180 70 20 0 180 70 20 0 180 70 20 0 
255 200 0 0 255 200 0 0 255 200 0 0 255 200 0 0 255 200 0 0 255 200 0 0 255 200 0 0 255 200 0 0 255 200 0 0 255 200 0 0 255 200 0 0 255 200 0 0 255 200 0 0 
255 200 0 0 255 200 0 0 255 200 0 0 255 200 0 0 255 200 0 0 255 200 0 0 255 200 0 0 255 200 0 0 255 200 0 0 255 200 0 0 255 200 0 0 255 200 0 0 255 200 0 0 
50 200 50 0 50 200 50 0 50 200 50 0 50 200 50 0 50 200 50 0 50 200 50 0 50 200 50 0 50 200 50 0 50 200 50 0 50 200 50 0 50 200 50 0 50 200 50 0 50 200 50 0 
50 200 50 0 50 200 50 0 50 200 50 0 50 200 50 0 50 200 50 0 50 200 50 0 50 200 50 0 50 200 50 0 50 200 50 0 50 200 50 0 50 200 50 0 50 200 50 0 50 200 50 0 
50 70 255 0 50 70 255 0 50 70 255 0 50 70 255 0 50 70 255 0 50 70 255 0 50 70 255 0 50 70 255 0 50 70 255 0 50 70 255 0 50 70 255 0 50 70 255 0 50 70 255 0 
50 70 255 0 50 70 255 0 50 70 255 0 50 70 255 0 50 70 255 0 50 70 255 0 50 70 255 0 50 70 255 0 50 70 255 0 50 70 255 0 50 70 255 0 50 70 255 0 50 70 255 0 
50 70 255 0 50 70 255 0 50 70 255 0 50 70 255 0 50 70 255 0 50 70 255 0 50 70 255 0 50 70 255 0 50 70 255 0 50 70 255 0 50 70 255 0 50 70 255 0 50 70 255 0 
50 70 255 0 50 70 255 0 50 70 255 0 50 70 255 0 50 70 255 0 50 70 255 0 50 70 255 0 50 70 255 0 50 70 255 0 50 70 255 0 50 70 255 0 50 70 255 0 50 70 255 0 
