1 1 1 1 1 1 1 1 1 1 1 1 1 1 1 1 1 1 1 1 1 1 1 1 1 1 1 1 1 1 1 1 1 1 1 1 1 1 1 1 1 1 1 1 1 1 1 1 1 1 1 1 1 1 1 1  
0 0 0 1 180 50 10 0 180 50 10 0 180 50 10 0 180 50 10 0 180 50 10 0 180 50 10 0 180 50 10 0 180 50 10 0 180 50 10 0 180 50 10 0 180 50 10 0 180 50 10 0 0 0 0 1
0 0 0 1 180 50 10 0 180 50 10 0 180 50 10 0 180 50 10 0 180 50 10 0 180 50 10 0 180 50 10 0 180 50 10 0 180 50 10 0 180 50 10 0 180 50 10 0 180 50 10 0 0 0 0 1
0 0 0 1 180 50 10 0 180 50 10 0 180 50 10 0 180 50 10 0 180 50 10 0 180 50 10 0 180 50 10 0 180 50 10 0 180 50 10 0 180 50 10 0 180 50 10 0 180 50 10 0 0 0 0 1
0 0 0 1 180 50 10 0 180 50 10 0 180 50 10 0 180 50 10 0 180 50 10 0 180 50 10 0 180 50 10 0 180 50 10 0 180 50 10 0 180 50 10 0 180 50 10 0 180 50 10 0 0 0 0 1
0 0 0 1 180 70 20 0 180 70 20 0 180 70 20 0 180 70 20 0 180 70 20 0 180 70 20 0 180 70 20 0 180 70 20 0 180 70 20 0 180 70 20 0 180 70 20 0 180 70 20 0 0 0 0 1
0 0 0 1 180 70 20 0 180 70 20 0 180 70 20 0 180 70 20 0 180 70 20 0 180 70 20 0 180 70 20 0 180 70 20 0 180 70 20 0 180 70 20 0 180 70 20 0 180 70 20 0 0 0 0 1
0 0 0 1 255 200 0 0 255 200 0 0 255 200 0 0 255 200 0 0 255 200 0 0 255 200 0 0 255 200 0 0 255 200 0 0 255 200 0 0 255 200 0 0 255 200 0 0 255 200 0 0 0 0 0 1
0 0 0 1 255 200 0 0 255 200 0 0 255 200 0 0 255 200 0 0 255 200 0 0 255 200 0 0 255 200 0 0 255 200 0 0 255 200 0 0 255 200 0 0 255 200 0 0 255 200 0 0 0 0 0 1
0 0 0 1 50 200 50 0 50 200 50 0 50 200 50 0 50 200 50 0 50 200 50 0 50 200 50 0 50 200 50 0 50 200 50 0 50 200 50 0 50 200 50 0 50 200 50 0 50 200 50 0 0 0 0 1
0 0 0 1 50 200 50 0 50 200 50 0 50 200 50 0 50 200 50 0 50 200 50 0 50 200 50 0 50 200 50 0 50 200 50 0 50 200 50 0 50 200 50 0 50 200 50 0 50 200 50 0 0 0 0 1
0 0 0 1 50 70 255 0 50 70 255 0 50 70 255 0 50 70 255 0 50 70 255 0 50 70 255 0 50 70 255 0 50 70 255 0 50 70 255 0 50 70 255 0 50 70 255 0 50 70 255 0 0 0 0 1
0 0 0 1 50 70 255 0 50 70 255 0 50 70 255 0 50 70 255 0 50 70 255 0 50 70 255 0 50 70 255 0 50 70 255 0 50 70 255 0 50 70 255 0 50 70 255 0 50 70 255 0 0 0 0 1
1 1 1 1 1 1 1 1 1 1 1 1 1 1 1 1 1 1 1 1 1 1 1 1 1 1 1 1 1 1 1 1 1 1 1 1 1 1 1 1 1 1 1 1 1 1 1 1 1 1 1 1 1 1 1 1  
